1111111111111
10010000000C1
10000000C1001
1P00C0C00E001
1111111111111