1111111111111
1001000000001
1000000001001
1PCE000000001
1111111111111
